2222222222222222222222222222222222222222
2000000000000000000000000000000000000002
2000000000000000000000000000000000000002
2000000000000000000000000000000000000002
2000000000000000000000000000000000000002
2000000000000000000000000000000000000002
2000000000000000000000000000000000000002
2000000000000000000000000000000000000002
2000000000000000000000000000000000000002
2000000000000000000000000000000000000002
2000000000000000000000000000000000000002
2000000000000000000000000000000000000002
2000000000000000000000000000000000000002
2000000000000000000000000000000000000002
2000000000000000000000000000000000000002
2000000000000000000000000000000000000002
2000000000000000000000000000000000000002
2000000000000000000000000000000000000002
2000000000000000000000000000000000000002
2000000000000000000000000000000000000002
2000000000000000000000000000000000000002
2000000000000000000000000000000000000002
2000000000000000000000000000000000000002
2000000000000000000000000000000000000002
2000000000000000000000000000000000000002
2222222222222222222222222222222222222222
4444444444444444444444444444444444444444
4444444444444444444444444444444444444444
4444444444444444444444444444444444444444
4444444444444444444444444444444444444444
4444444444444444444444444444444444444444
4444444444444444444444444444444444444444
