2222222222222222222222222222222222222222
2000000000000000000000000000000000000002
2000111000000000000000000000000000000002
2000111000000000000133333333333331000002
2000010000000000000300000000000003000002
2000030000000000000300000000000003000002
2000030000000000000300000000000003000002
2000030000000000000300000000000003000002
2000030000000000000300000000000003000002
2000013333333333333100000000000003000002
2000000000000000000000000000000003000002
2000000000000000000000000000000003000002
2000000000000000000000000000000003000002
2000000000000000000000000000000003000002
2000000000000000000000000000000003000002
2000000000000000000000000000000003000002
2000013333333333333333333333333331000002
2000030000000000000000000000000000000002
2000030000000000000000000000000000000002
2000030000000000000000000000000000000002
2000030000000000000000000000000000000002
2000030000000000000000000000000011000002
2000013333333333333333333333333111000002
2000000000000000000000000000000011000002
2000000000000000000000000000000000000002
2222222222222222222222222222222222222222
4444444444444444444444444444444444444444
4444444444444444444444444444444444444444
4444444444444444444444444444444444444444
4444444444444444444444444444444444444444
4444444444444444444444444444444444444444
4444444444444444444444444444444444444444
