54
2222222222222222222222222222222222222222
2000000000000000000000000000000000000002
2000111000000000000000000000000000000002
2000111000000000000333333333333337000002
2000070000000000000800000000000007000002
2000070000000000000800000000000007000002
2000070000000000000800000000000007000002
2000070000000000000800000000000007000002
2000033333333333333800000000000007000002
2000000000000000000000000000000007000002
2000000000000000000000000000000007000002
2000000000000000000000000000000007000002
2000000000000000000000000000000007000002
2000000000000000000000000000000007000002
2000000000000000000000000000000007000002
2000079999999999999999999999999999000002
2000070000000000000000000000000000000002
2000070000000000000000000000000000000002
2000070000000000000000000000000000000002
2000070000000000000000000000000000000002
2000070000000000000000000000000011000002
2000033333333333333333333333333511000002
2000000000000000000000000000000011000002
2000000000000000000000000000000000000002
2222222222222222222222222222222222222222
4444444444444444444444444444444444444444
4444444444444444444444444444444444444444
4444444444444444444444444444444444444444
4444444444444444444444444444444444444444
4444444444444444444444444444444444444444
4444444444444444444444444444444444444444
