63
2222222222222222222222222222222222222222
2000000000000000000000000000000000000002
2000110000000000000000000000000000000002
2000111333700000000033333333333337000002
2000110000700000000080000000000007000002
2000000000700000000080000000000007000002
2000000000333333333380000000000007000002
2000000000000000000000000000000007000002
2000007999999999999999999999999999000002
2000007000000000000000000000000000000002
2000007000000000333333333333333337000002
2000007000000000800000000000000007000002
2000007000000000800000000000000007000002
2000007000000000800000000000000007000002
2000007000000000800000000000000007000002
2000007000000000800000000000000007000002
2000007000000000800000000000000007000002
2000007000000000800000000000000007000002
2000007000000000800000000000000007000002
2000003333333333800000000000000007000002
2000000000000000000000000000000007000002
2000110000000000000000000000000007000002
200011B999999999999999999999999999000002
2000110000000000000000000000000000000002
2000000000000000000000000000000000000002
2222222222222222222222222222222222222222
4444444444444444444444444444444444444444
4444444444444444444444444444444444444444
4444444444444444444444444444444444444444
4444444444444444444444444444444444444444
4444444444444444444444444444444444444444
4444444444444444444444444444444444444444